5 8

.......D
O...##..
..O.....
..###...
P.....#.